20
20
HHLLLHHPPPFFFFFPPPPP
HHLLLHHPPPFFFFFPPPPP
HHLLLHHHPPPFFFFLLLLL
HHPPPPHHHHPPPPPPFFFF
PPPPPPFFLLLLLPPPPPPP
HHHHLLLLLLLLLLLPPPPP
HHHHHLLLLLLLLLLLFFFF
HHHLLLLLLLLLLLLLLFFF
PPPLLLLLLLLLLLLFFFFF
PPPPPPLLLLLLLFFFFFHH
PPPPPPPPLLLFFFFFFHHH
FFFFPPPPPPPPFFHHHHHH
FFFFFFPPPPPPPHHHHHHH
FLLLLLFFFFPPHHHHHHHH
FFLLLLLFFFHHHHHLLLHH
FFFFFFFFHHHHHHHLLLHH
FFFFFPPPPPHHHHLLLHHH
FFFFPPPPPHHHHHHHHHHH
FFFPPPPPPPPHHHHHHHHH
FPPPPPPPPPPPPPPHHHHH
hop east 0 1
path_finder north 0 2
flytrap south 0 3
food south 7 11 f
hop west 9 13 f
flytrap east 3 3 f a
lrover west 11 11 f a
rrover north 15 17 f
alt_rover west 9 19 a
flytrap south 14 10
landmine north 19 10
path_finder east 12 13 a
